8-5
CC.TTC.C
.O.TTC..
....TC.T
..@...C.
C....C.C
